11111111111111
11111110011111
11111111100111
11
11111111100111
111111111111111111