NO ./textures/wall.png
SO ./textures/wall.png
WE ./textures/wall.png
EA ./textures/wall.png

F 112,128,144
C 135,206,235


111111111111
1S0000000011
100010000001
111110111111
    1D1     
111110111111
1001001010011
101000100001
110000000001
111111111111