NO ./textures/wall.png
SO ./textures/wall.png
WE ./textures/wall.png
EA ./textures/wall.png

F 112,128,144
C 135,206,235


111111111111111111
100000000000000001
100000000000000001
10000000S000000001
100000001000000001
100000000000000001
100000000000000001
100000000000000001
111111111111111111