NO ./textures/wall.png
SO ./textures/wall.png
WE ./textures/wall.png
EA ./textures/wall.png

F 112,128,144
C 135,206,235


111111111111111111111
1S00000000000D0000011
100000000000010000001
100000000000010111111
10000000000001D1     
100000000000010111111
1000000000000001010011
101000000000000100001
110000000000000000001
110000000000000000001
110000000000000000001
110000000000000000001
110000000000000000001
111111111111111111111