NO ./bonus/textures/wall.png
SO ./bonus/textures/wall.png
WE ./bonus/textures/wall.png
EA ./bonus/textures/wall.png

F 112,128,
C 135,206,235


1111111111111111111
1000000S00000000001
1000001010000000001
1000001D10000000001
1000000000000000001
1111111111111111111