NO ./bonus/textures/wall.png
SO ./bonus/textures/wall.png
WE ./bonus/textures/wall.png
EA ./bonus/textures/wall.png

F 112,128,144
C 135,206,235


111111111111111111111
1S0D00D000000D0000011
111111110000010000001
100000000000010111111
10000000000001D1
10000000000001D111111
1000000000000001010011
101000000000000100001
110000000000000000001
110000000000000000001
110000000000000000001
110000000000000000001
110000000000000000001
111111111111111111111