NO ./bonus/textures/wall.png
SO ./bonus/textures/wall.png
WE ./bonus/textures/wall.png
EA ./bonus/textures/wall.png

F 112,128,144
C 135,206,235


1111111111111111111
1000000000000000001
11001111D111100001
100000000000000001
1000000000000000011
1000000000000000001
100000000W000000001
1111111111111111111