NO ./mandatory/textures/wall.png
SO ./mandatory/textures/wall.png
WE ./mandatory/textures/wall.png
EA ./mandatory/textures/wall.png

F 112,128,
C 135,206,235

111111111111
10N000000001                                    
100000000001
100000000001
100100000001
100010000001
100000000001
100000000001                  
111111111111            