NO ./mandatory/textures/wall.png
SO ./mandatory/textures/wall.png
WE ./mandatory/textures/wall.png
EA ./mandatory/textures/wall.png

F 112,128,144
C 135,206,235


111111111111111111111
1S0000000000000000011
100000000000010000001
100000000000010111111
100000000000011
100000000000010111111
1000000000000001010011
101000000000000100001
110000000000000000001
110000000000000000001
110000000000000000001
110000000000000000001
110000000000000000001
111111111111111111111