NO ./mandatory/textures/NORTH.png
SO ./mandatory/textures/SOUTH.png
WE ./mandatory/textures/WEST.png
EA ./mandatory/textures/EAST.png

F 112,128,144
C 135,206,235


11111111111
10000000001
10000000001
10000100001
10000000001
100000W0001
11111111111